****************
*             E*
*              *
*              *
*              *
*              *
*S             *
****************