***********
*        E*
*         *
*****     *
*         *
*    *    *
*S   *    *
***********