******
*    *
*    *
*    *
*S* E*
******