****************
*S    *        *
*** *    * *   *
*   * *  * *****
*     *  * *   *
*******  * *  **
*           * E*
****************