***********************
*S    *      *        *
*** *    * *    * *   *
*   * *  * * *  *******
*     *  *      ** *  *
*******  ***** **    **
*        * * *  * **  *
*   * **** * *  * *** *
*   *           * *   *
* *****  ******** * ***
*     *  *     *  *   *
***** **** *** * **** *
*            *   *E   *
***********************