****************
*S             *
*              *
*              *
*              *
*              *
*             E*
****************