***********
*    *   E*
*    *  ***
*    *    *
*S        *
***********