****************
*              *
*S             *
*              *
*              *
*              *
*             E*
****************